11,11,11,11,11,11,11,11,11,11,11,11,11,11,11,11,11,11,11,11,11,11,11,11,11,11,11,11,11,11,11,11,11,11,11,11,11,11,11,11,11,11,11,
11,11,11,11,11,11,11,11,11,11,11,11,11,11,11,11,11,11,11,11,11,11,11,11,11,11,11,9,9,9,9,9,9,9,11,11,11,11,11,11,11,11,11,
11,11,11,11,11,11,11,11,11,11,11,11,11,11,11,11,11,11,11,11,11,11,11,11,11,11,11,9,6,6,6,6,6,6,9,11,11,11,11,11,11,11,11,
11,11,11,11,11,11,11,11,11,11,11,11,11,11,11,11,11,11,11,11,11,11,11,11,11,11,11,9,6,6,6,6,6,6,6,9,11,11,11,11,11,11,11,
11,11,11,11,11,11,11,11,11,11,11,11,11,11,11,11,11,11,11,11,11,11,11,11,11,11,11,9,6,6,6,6,6,6,6,6,9,11,11,11,11,11,11,
11,11,11,11,11,11,11,11,11,11,11,11,11,11,11,11,11,11,11,11,11,11,11,11,11,11,11,9,6,6,6,6,6,6,6,6,6,9,11,11,11,11,11,
11,11,11,11,11,11,11,11,11,11,6,6,11,11,11,11,11,11,11,11,11,6,6,6,6,6,6,6,6,6,6,6,6,6,6,6,6,6,9,11,11,11,11,
11,11,11,11,11,11,11,11,11,6,6,6,6,6,11,11,11,11,11,11,6,6,6,6,6,6,6,6,6,6,6,6,6,6,6,6,6,6,6,9,11,11,11,
11,11,11,11,11,11,11,6,6,6,6,6,6,6,6,11,11,11,11,6,6,6,6,6,6,6,6,6,6,6,6,6,6,6,6,6,6,11,11,11,11,11,11,
11,11,11,11,11,11,6,6,6,6,6,9,6,6,6,6,11,11,6,6,6,11,11,11,11,6,6,6,6,6,6,6,6,6,6,6,11,11,11,11,11,11,11,
11,11,11,11,11,11,6,6,6,6,9,9,9,6,6,6,6,6,6,6,11,11,11,11,11,11,6,6,6,6,6,6,6,6,6,6,11,11,11,11,11,11,11,
11,11,11,11,11,11,6,6,6,6,6,9,6,6,6,6,6,6,6,11,11,11,11,11,11,11,11,6,6,6,6,6,6,6,6,6,11,11,11,11,11,11,11,
11,11,11,11,11,11,11,6,6,6,6,6,6,6,6,6,6,6,11,11,11,11,11,11,11,11,11,11,6,6,6,6,6,6,6,11,11,11,11,11,11,11,11,
11,11,11,11,11,11,11,11,11,6,6,6,6,6,11,11,11,11,11,11,11,11,11,11,11,11,11,11,11,6,6,6,6,11,11,11,11,11,11,11,11,11,11,
11,11,11,11,11,11,11,11,11,11,6,6,6,11,11,11,11,11,11,11,11,11,11,11,11,11,11,11,11,11,6,6,6,11,11,11,11,11,11,11,11,11,11,
11,11,11,11,11,11,11,11,11,11,11,11,11,11,11,11,11,11,11,11,11,11,11,11,11,11,11,11,11,11,11,6,6,11,11,11,11,11,11,11,11,11,11,
11,11,11,11,11,11,11,11,11,11,11,11,11,11,11,11,11,11,11,11,11,11,11,11,11,11,11,11,11,11,11,6,6,11,11,11,11,11,11,11,11,11,11,
11,11,11,11,11,11,11,11,11,11,11,11,11,11,11,11,11,11,11,11,11,11,11,11,11,11,11,11,11,11,11,6,6,11,11,11,11,11,11,11,11,11,11,
11,11,11,11,11,11,11,11,11,11,11,11,11,11,11,11,11,11,11,11,11,11,11,11,11,11,11,11,6,6,6,6,6,11,11,11,11,11,11,11,11,11,11,
11,11,11,11,11,11,11,11,11,11,11,11,11,11,11,11,11,11,11,11,11,11,11,11,11,11,11,6,6,6,6,6,6,11,11,11,11,11,11,11,11,11,11,
11,11,11,11,11,11,11,11,11,11,11,11,11,11,11,11,11,11,11,11,11,11,11,11,11,6,6,6,6,6,6,6,11,11,11,11,11,11,11,11,11,11,11,
11,11,11,11,11,11,11,11,11,11,11,11,11,11,11,11,11,11,11,11,11,11,11,11,6,6,6,6,6,6,11,11,11,11,11,11,11,11,11,11,11,11,11,
11,11,11,11,11,11,11,11,11,11,11,11,11,11,11,11,11,11,11,11,11,11,11,11,6,6,6,6,6,11,11,11,11,11,11,11,11,11,11,11,11,11,11,
11,11,11,11,11,11,11,11,11,11,11,11,11,11,11,11,11,11,11,11,11,11,11,11,6,6,6,11,11,11,11,11,11,11,11,11,11,11,11,11,11,11,11,